3,0 3,0     3,0     3,0     3,0     3,0     3,0 3,0 3,0     3,0     3,0     3,0     3,0     3,0     3,0
3,0 3,0     3,0     3,0     3,0     3,0     3,0 3,0 3,0     3,0     3,0     3,0     3,0     3,0     3,0
3,0 3,0     3,0     3,0     3,0     3,0     3,0 3,0 3,0     0,0     3,0     3,0     3,0     3,0     3,0
3,0 0,0     0,0t6,8 0,0t6,9 0,0     0,0     0,0 0,0 0,0     0,0     0,0     0,0     0,0     0,0     3,0
3,0 3,0     0,0     0,0     0,0     0,0     0,0 0,0 0,0     0,0     0,0     0,0     0,0     0,0     3,0
3,0 3,0     3,0     3,0     0,0     0,0     0,0 0,0 0,0     3,0     3,0     3,0     0,0     0,0     3,0
3,0 0,0     3,0     3,0     0,0     0,0     0,0 0,0 0,0     0,0     0,0     0,0     0,0     0,0     3,0
3,0 0,0t6,6 0,0t6,6 0,0t6,7 0,0t6,6 0,0t6,7 0,0 0,0 0,0     0,0t6,6 0,0t6,7 0,0t6,6 0,0t6,7 0,0t6,7 3,0
3,0 0,0     0,0     0,0     0,0     0,0     0,0 0,0 0,0     0,0     0,0     0,0     0,0     0,0     3,0
3,0 3,0     3,0     3,0     3,0     3,0     0,0 0,0 0,0     3,0     3,0     3,0     3,0     3,0     3,0
3,0 0,0     0,0     0,0     0,0     0,0     0,0 0,0 0,0     0,0     0,0     0,0     0,0     0,0     3,0
3,0 0,0t6,5 0,0     0,0     0,0     0,0     0,0 0,0 0,0     0,0     0,0     0,0     0,0     0,0t6,5 3,0
3,0 0,0     0,0     0,0     0,0     0,0     0,0 0,0 0,0     0,0     0,0     0,0     0,0     0,0     3,0
3,0 3,0     0,0     0,0     0,0     0,0     0,0 0,0 0,0     0,0     0,0     0,0     0,0     3,0     3,0
3,0 3,0     3,0     3,0     3,0     3,0     3,0 3,0 3,0     3,0     3,0     3,0     3,0     3,0     3,0
3,0 3,0     3,0     3,0     3,0     3,0     3,0 3,0 3,0     3,0     3,0     3,0     3,0     3,0     3,0
