2,3 2,2 2,3 2,2 2,3 2,2 2,3 2,2 2,3 2,2 2,3 2,2 2,3     2,2     2,3     2,2     2,3     2,2 1,3 0,7  0,8  1,2 2,3 2,2 2,3 2,2 2,3 2,2 2,3 2,2 2,3 2,2 2,3 2,2 2,3 2,2 2,3 2,2
2,5 2,4 2,5 2,4 2,5 2,4 2,5 2,4 2,5 1,4 1,5 1,4 1,5     1,4     1,5     1,4     1,5     1,4 1,5 0,1  0,2  1,4 1,5 1,4 1,5 1,4 1,5 1,4 1,5 2,4 2,5 2,4 2,5 2,4 2,5 2,4 2,5 2,4
2,3 2,2 2,3 2,2 2,3 2,2 2,3 2,2 1,3 0,7 0,3 0,3 0,3     0,3     0,3     0,3     0,3     0,3 0,3 0,12 0,11 0,3 0,3 0,3 0,3 0,3 0,3 0,3 5,4 1,2 2,3 2,2 2,3 2,2 2,3 2,2 2,3 2,2
2,5 2,4 2,5 2,4 2,5 2,4 2,5 2,4 2,5 0,1 0,0 0,0 0,0t8,0 0,0t8,1 0,0t8,1 0,0t8,1 0,0t8,2 0,0 0,0 0,0  0,0  0,0 0,0 0,0 0,0 0,0 0,0 0,0 5,5 2,4 2,5 2,4 2,5 2,4 2,5 2,4 2,5 2,4
2,3 2,2 2,3 2,2 2,3 2,2 2,3 2,2 1,3 0,1 5,8 5,9 8,4
2,5 2,4 2,5 2,4 2,5 2,4 2,5 2,4 2,5 0,1 5,5
2,3 2,2 2,3 2,2 2,3 2,2 2,3 2,2 1,3 0,1 5,5
2,5 2,4 2,5 2,4 2,5 2,4 2,5 2,4 2,5 0,1 5,5
2,3 2,2 2,3 2,2 2,3 2,2 2,3 2,2 1,3 0,1 5,7
2,5 2,4 2,5 2,4 2,5 2,4 2,5 2,4 2,5 0,1 0,0
2,3 2,2 2,3 2,2 2,3 2,2 2,3 2,2 1,3 0,1 0,0
2,5 2,4 2,5 2,4 2,5 2,4 2,5 2,4 2,5 0,1 0,0
2,3 2,2 2,3 2,2 2,3 2,2 2,3 2,2 1,3 0,1 0,0
2,5 2,4 2,5 2,4 2,5 2,4 2,5 2,4 2,5 0,1 0,0
2,3 2,2 2,3 2,2 2,3 2,2 2,3 2,2 1,3 0,1 0,0
2,5 2,4 2,5 2,4 2,5 2,4 2,5 2,4 2,5 0,1 0,0
2,3 2,2 2,3 2,2 2,3 2,2 2,3 2,2 1,3 0,1 0,0
2,5 2,4 2,5 2,4 2,5 2,4 2,5 2,4 2,5 0,1 0,0
2,3 2,2 2,3 2,2 2,3 2,2 2,3 2,2 1,3 0,1 0,0
2,5 2,4 2,5 2,4 2,5 2,4 2,5 2,4 2,5 0,1
2,3 2,2 2,3 2,2 2,3 2,2 2,3 2,2 1,3 0,1
2,5 2,4 2,5 2,4 2,5 2,4 2,5 2,4 2,5 0,1
2,3 2,2 2,3 2,2 2,3 2,2 2,3 2,2 1,3 0,1
2,5 2,4 2,5 2,4 2,5 2,4 2,5 2,4 2,5 0,1
