2,3 2,2 2,3 2,2 2,3 2,2 2,3 2,2      2,3     2,2     2,3      2,2      2,3      2,2      2,3     2,2  1,3 0,7  0,8     1,2     2,3     2,2     2,3     2,2     2,3  2,2 2,3 2,2 2,3 2,2 2,3 2,2 2,3 2,2 2,3 2,2
2,5 2,4 2,5 2,4 2,5 2,4 2,5 1,4      1,5     1,4     1,5      1,4      1,5      1,4      1,5     1,4  1,5 0,1  0,2     1,4     1,5     1,4     1,5     1,4     1,5  1,4 1,5 2,4 2,5 2,4 2,5 2,4 2,5 2,4 2,5 2,4
2,3 2,2 2,3 2,2 2,3 2,2 1,3 0,7      0,3     0,3     0,3      0,3      0,3      0,3      0,3     0,3  0,3 0,12 0,11    0,3     0,3     0,3     0,3     0,3     0,3  0,3 5,4 1,2 2,3 2,2 2,3 2,2 2,3 2,2 2,3 2,2
2,5 2,4 2,5 2,4 2,5 2,4 2,5 0,1      0,0     0,0     0,0t8,0  0,0t8,1  0,0t8,1  0,0t8,1  0,0t8,2 0,0  0,0 0,0  0,0     0,0t8,0 0,0t8,1 0,0t8,1 0,0t8,1 0,0t8,2 0,0  0,0 5,5 2,4 2,5 2,4 2,5 2,4 2,5 2,4 2,5 2,4
2,3 2,2 2,3 2,2 2,3 2,2 1,3 0,1      5,8     5,9     8,3      8,4      8,4      8,4      8,5     5,11 0,0 5,8  5,9     8,3     8,4     8,4     8,4     8,5     5,11 0,0 5,5 1,2 2,3 2,2 2,3 2,2 2,3 2,2 2,3 2,2
2,5 2,4 2,5 2,4 2,5 2,4 2,5 0,1      5,5     5,2     8,6      8,7      8,7      8,7      8,8     5,6  0,0 5,5  5,0     8,6     8,7     8,7     8,7     8,8     5,6  0,0 5,5 2,4 2,5 2,4 2,5 2,4 2,5 2,4 2,5 2,4
2,3 2,2 2,3 2,2 2,3 2,2 1,3 0,1      5,5     5,3t6,4 8,9      8,10     8,11     8,12     8,13    5,6  0,0 5,5  5,3t6,4 8,9     8,10    8,11    8,12    8,13    5,6  0,0 5,5 1,2 2,3 2,2 2,3 2,2 2,3 2,2 2,3 2,2
2,5 2,4 2,5 2,4 2,5 2,4 2,5 0,1      5,5     6,3     8,14     8,15     8,16     8,17     8,18    5,6  0,0 5,5  6,3     8,14    8,15    8,16    8,17    8,18    5,6  0,0 5,5 2,4 2,5 2,4 2,5 2,4 2,5 2,4 2,5 2,4
2,3 2,2 2,3 2,2 2,3 2,2 1,3 0,1      5,7     0,3     5,10     0,0      5,7      0,3      0,3     5,10 0,0 5,7  0,3     5,10    0,0     5,7     0,3     0,3     5,10 0,0 5,5 1,2 2,3 2,2 2,3 2,2 2,3 2,2 2,3 2,2
2,5 2,4 2,5 2,4 2,5 2,4 2,5 0,1      0,0     0,0     0,0      0,0      0,0      0,0      0,0     0,0  0,0 0,0  0,0     0,0     0,0     0,0     0,0     0,0     0,0  0,0 5,5 2,4 2,5 2,4 2,5 2,4 2,5 2,4 2,5 2,4
2,3 2,2 2,3 2,2 2,3 2,2 1,3 0,1      0,0     0,0     0,0      0,0      0,0      0,0      0,0     0,0  0,0 5,8
2,5 2,4 2,5 2,4 2,5 2,4 2,5 0,1      0,0     5,8     5,9tb3,1 5,9tb3,1 5,9tb3,1 5,9tb3,1 6,1     5,11 0,0 5,5
2,3 2,2 2,3 2,2 2,3 2,2 1,3 0,1      0,0     5,5     1,9      1,9      1,9      1,9      5,1     5,6  0,0 5,5
2,5 2,4 2,5 2,4 2,5 2,4 2,5 0,1      0,0     5,5     1,9      1,9      1,9      1,9      5,2     5,6  0,0 5,5
2,3 2,2 2,3 2,2 2,3 2,2 1,3 0,1      0,0     5,5     6,2      5,0      5,1      5,3      5,1     5,6  0,0 5,7
2,5 2,4 2,5 2,4 2,5 2,4 2,5 0,1      0,0     5,7     0,3      0,3      0,3      0,3      0,3     5,10 0,0 5,8
2,3 2,2 2,3 2,2 2,3 2,2 1,3 0,1      0,0     0,0     0,0      0,0      0,0      0,0      0,0     0,0  0,0 5,7
2,5 2,4 2,5 2,4 2,5 2,4 2,5 5,12     5,9     5,9     5,9      5,9      1,8      1,10     1,10    1,11 0,0 0,0
2,3 2,2 2,3 2,2 2,3 2,2 1,3 5,2      5,3     5,3     5,0      5,2      1,8      1,10     1,10    1,11
2,5 2,4 2,5 2,4 2,5 2,4 2,5 5,1t1,0  5,1t1,1 5,2t1,0 5,1t1,1  5,2      1,8      1,10     1,10    1,11
2,3 2,2 2,3 2,2 2,3 2,2 1,3 1,2      1,3     1,2     1,3      5,3tb3,2 1,8      1,10     1,10    1,11
2,5 2,4 2,5 2,4 2,5 2,4 2,5 2,4      2,5     2,4     2,5      3,4      1,8      1,10     1,10    1,11
2,3 2,2 2,3 2,2 2,3 2,2 1,3 2,2      2,3     2,2     2,3      3,4      1,8      1,10     1,10    1,11
2,5 2,4 2,5 2,4 2,5 2,4 2,5 2,4      2,5     2,4     2,5      3,4      1,8      1,10     1,10    1,11
