3,0 3,0     3,0 3,0 3,0 3,0 3,0 3,0 3,0 3,0 3,0 3,0 3,0     3,0
3,0 3,0     3,0 3,0 3,0 3,0 3,0 3,0 3,0 3,0 3,0 3,0 3,0     3,0
3,0 3,0     3,0 3,0 3,0 3,0 3,0 3,0 3,0 3,0 3,0 3,0 3,0     3,0
3,0 0,0     0,0 0,0 0,0 0,0 0,0 0,0 0,0 0,0 0,0 3,0 3,0     3,0
3,0 0,0     0,0 0,0 0,0 0,0 0,0 0,0 0,0 0,0 0,0 3,0 3,0     3,0
3,0 0,0     0,0 0,0 0,0 0,0 3,0 3,0 0,0 0,0 0,0 0,0 0,0     3,0
3,0 0,0t6,5 0,0 0,0 0,0 0,0 3,0 3,0 0,0 0,0 0,0 0,0 0,0t6,5 3,0
3,0 0,0     0,0 0,0 0,0 0,0 0,0 0,0 0,0 0,0 0,0 0,0 0,0     3,0
3,0 3,0     0,0 0,0 0,0 0,0 0,0 0,0 0,0 0,0 0,0 0,0 3,0     3,0
3,0 0,0     0,0 0,0 0,0 0,0 0,0 0,0 0,0 0,0 0,0 0,0 0,0     3,0
3,0 3,0     3,0 3,0 3,0 3,0 3,0 3,0 3,0 3,0 3,0 3,0 3,0     3,0
3,0 3,0     3,0 3,0 3,0 3,0 3,0 3,0 3,0 3,0 3,0 3,0 3,0     3,0
