2,3 2,2 2,3 2,2 2,3 2,2 2,3 2,2      2,3      2,2      2,3      2,2     2,3     2,2     2,3      2,2       2,3       0,0       0,0      2,2       2,3       2,2      2,3      2,2     2,3     2,2     2,3     2,2     2,3     2,2 2,3 2,2 2,3 2,2 2,3 2,2 3,0
2,5 2,4 2,5 2,4 2,5 2,4 2,5 2,4      2,5      2,4      2,5      2,4     2,5     2,4     2,5      2,4       2,5       2,4       2,5      2,4       2,5       2,4      2,5      2,4     2,5     2,4     2,5     2,4     2,5     2,4 2,5 2,4 2,5 2,4 2,5 2,4 3,0
2,3 2,2 2,3 2,2 2,3 2,2 2,3 2,2      2,3      2,2      2,3      2,2     2,3     2,2     2,3      2,2       2,3       2,2       2,3      2,2       2,3       2,2      2,3      2,2     2,3     2,2     2,3     2,2     2,3     2,2 2,3 2,2 2,3 2,2 2,3 2,2 3,0
2,5 2,4 2,5 2,4 2,5 2,4 2,5 2,4      2,5      2,4      2,5      2,4     2,5     2,4     2,5      2,4       2,5       2,4       2,5      2,4       2,5       2,4      2,5      2,4     2,5     2,4     2,5     2,4     2,5     2,4 2,5 2,4 2,5 2,4 2,5 2,4 3,0
2,3 2,2 2,3 2,2 2,3 2,2 2,3 2,2      2,3      2,2      2,3      2,2     2,3     2,2     2,3      2,2       2,3       2,2       2,3      2,2       2,3       2,2      2,3      2,2     2,3     2,2     2,3     2,2     2,3     2,2 2,3 2,2 2,3 2,2 2,3 2,2 3,0
2,5 2,4 2,5 2,4 2,5 2,4 2,5 2,4      2,5      2,4      2,5      2,4     2,5     2,4     2,5      2,4       2,5       2,4       2,5      2,4       2,5       2,4      2,5      2,4     2,5     2,4     2,5     2,4     2,5     2,4 2,5 2,4 2,5 2,4 2,5 2,4 3,0
2,3 2,2 2,3 2,2 2,3 2,2 2,3 2,2      2,3      2,2      2,3      2,2     2,3     2,2     2,3      2,2       2,3       2,2       2,3      2,2       2,3       2,2      2,3      2,2     2,3     2,2     2,3     2,2     2,3     2,2 2,3 2,2 2,3 2,2 2,3 2,2 3,0
2,5 2,4 2,5 2,4 2,5 2,4 2,5 2,4      2,5      2,4      2,5      2,4     2,5     2,4     2,5      2,4       2,5       2,4       2,5      2,4       7,7       7,3      7,3      7,3     7,3     7,3     7,8     2,4     2,5     2,4 2,5 2,4 2,5 2,4 2,5 2,4 3,0
2,3 2,2 2,3 2,2 2,3 2,2 2,3 2,2      2,3      2,2      2,3      2,2     2,3     2,2     2,3      2,2       2,3       2,2       2,3      2,2       7,1       7,9      7,4      7,4     7,4     7,10    7,2     2,2     2,3     2,2 2,3 2,2 2,3 2,2 2,3 2,2 3,0
2,5 2,4 2,5 2,4 2,5 2,4 2,5 2,4      2,5      2,4      2,5      2,4     2,5     2,4     7,1      7,2       2,5       2,4       2,5      2,4       7,1       7,2      2,5      2,4     2,5     7,1     7,2     2,4     2,5     2,4 2,5 2,4 2,5 2,4 2,5 2,4 3,0
2,3 2,2 2,3 2,2 2,3 2,2 2,3 2,2      2,3      2,2      2,3      2,2     2,3     2,2     7,5      7,6       5,0       2,2       2,3      5,0       7,5       7,6      2,3      2,2     2,3     7,1     7,2     2,2     2,3     2,2 2,3 2,2 2,3 2,2 2,3 2,2 3,0
2,5 2,4 2,5 2,4 2,5 2,4 2,5 2,4      2,5      2,4      2,5      2,4     2,5     2,4     2,5      5,3       5,0       5,0       5,1      5,0       5,0       5,0      2,5      2,4     2,5     7,1     7,2     2,4     2,5     2,4 2,5 2,4 2,5 2,4 2,5 2,4 3,0
2,3 2,2 2,3 2,2 2,3 2,2 2,3 2,2      2,3      2,2      2,3      2,2     2,3     2,2     5,0      5,1       5,0       5,1       5,3      5,0       5,1       5,0      2,3      2,2     2,3     7,1     7,2     2,2     2,3     2,2 2,3 2,2 2,3 2,2 2,3 2,2 3,0
2,5 2,4 2,5 2,4 2,5 2,4 2,5 2,4      2,5      2,4      2,5      2,4     2,5     2,4     5,0      14,0      14,1      14,1      14,1     14,1      14,2      5,2      2,5      2,4     2,5     7,1     7,2     2,4     2,5     2,4 2,5 2,4 2,5 2,4 2,5 2,4 3,0
2,3 2,2 2,3 2,2 2,3 2,2 2,3 2,2      2,3      2,2      2,3      2,2     2,3     2,2     5,0      14,3      14,4      14,4      14,4     14,4      14,5      5,1      2,3      2,2     2,3     7,1     7,2     2,2     2,3     2,2 2,3 2,2 2,3 2,2 2,3 2,2 3,0
2,5 2,4 2,5 2,4 2,5 2,4 2,5 2,4      2,5      2,4      2,5      2,4     2,5     2,4     5,1      14,6      14,7      14,7      14,7     14,7      14,8      5,1      2,5      2,4     2,5     7,1     7,2     2,4     2,5     2,4 2,5 2,4 2,5 2,4 2,5 2,4 3,0
2,3 2,2 2,3 2,2 2,3 2,2 2,3 2,2      2,3      2,2      2,3      2,2     2,3     2,2     5,0      14,9      14,10     14,11     14,12    14,13     14,14     5,0      2,3      2,2     2,3     7,1     7,2     2,2     2,3     2,2 2,3 2,2 2,3 2,2 2,3 2,2 3,0
2,5 2,4 2,5 2,4 2,5 2,4 2,5 2,4      2,5      2,4      2,5      2,4     2,5     2,4     5,0      14,15     14,16     14,17     14,18    14,19     14,20     5,0      2,5      2,4     2,5     7,1     7,2     2,4     2,5     2,4 2,5 2,4 2,5 2,4 2,5 2,4 3,0
2,3 2,2 2,3 2,2 2,3 2,2 2,3 2,2      2,3      2,2      2,3      2,2     2,3     2,2     5,1      5,0       5,1       5,1       5,3      5,2       5,3       5,2      2,3      2,2     2,3     7,1     7,2     2,2     2,3     2,2 2,3 2,2 2,3 2,2 2,3 2,2 3,0
2,5 2,4 2,5 2,4 2,5 2,4 2,5 2,4      2,5      2,4      2,5      2,4     2,5     2,4     2,5      2,4       2,5       2,4       2,5      2,4       2,5       2,4      2,5      2,4     2,5     7,1     7,2     2,4     2,5     2,4 2,5 2,4 2,5 2,4 2,5 2,4 3,0
2,3 2,2 2,3 2,2 2,3 2,2 2,3 2,2      2,3      2,2      2,3      2,2     7,1     7,2     2,3      2,2       2,3       2,2       2,3      2,2       2,3       2,2      2,1      2,2     2,5     7,1     7,2     2,2     2,3     2,2 2,3 2,2 2,3 2,2 2,3 2,2 3,0
2,5 2,4 2,5 2,4 2,5 2,4 2,5 2,4      2,5      2,4      2,5      2,4     7,1     7,2     2,5      1,4       1,5       1,4       1,5      1,4       1,5       2,4      2,1      2,2     2,5     7,1     7,2     2,4     2,5     2,4 2,5 2,4 2,5 2,4 2,5 2,4 3,0
2,3 2,2 2,3 2,2 2,3 2,2 2,3 2,2      2,3      2,2      2,3      2,2     7,1     7,11    7,3      7,3       7,3       7,3       7,3      7,3       7,3       7,3      7,3      7,3     7,3     7,12    7,2     2,2     2,3     2,2 2,3 2,2 2,3 2,2 2,3 2,2 3,0
2,5 2,4 2,5 2,4 2,5 2,4 2,5 2,4      2,5      2,4      2,5      2,4     7,5     7,4     7,4      7,10      7,0       7,0       7,0      7,0       7,9       7,4      7,4      2,6     2,5     2,4     7,6     2,4     2,5     2,4 2,5 2,4 2,5 2,4 2,5 2,4 3,0
2,3 2,2 2,3 2,2 2,3 2,2 1,3 2,2      1,3      2,2      1,3      2,2     2,3     2,2     1,3      7,1       7,0       7,9       7,10     7,0       7,2       2,2      2,3      2,2     2,3     2,2     2,3     2,2     2,3     2,2 2,3 2,2 2,3 2,2 2,3 2,2 3,0
2,5 2,4 2,5 2,4 2,5 2,4 2,5 1,4      1,5      1,4      1,5      1,4     1,5t1,0 1,4t1,1 1,5      7,1       7,0       7,11      7,12     7,0       7,2       1,4      1,5      1,4     1,5     1,4     1,5     1,4     1,5     2,4 2,5 2,4 2,5 2,4 2,5 2,4 3,0
2,3 2,2 2,3 2,2 2,3 2,2 1,3 5,0ao12  5,0      5,0ao12  5,0      5,0     2,2     2,3     5,0      7,1       7,0       7,0       7,0      7,0       7,11      7,3      7,3      7,3     7,3     7,3     7,3     7,3     7,8     1,2 2,3 2,2 2,3 2,2 2,3 2,2 3,0
2,5 2,4 2,5 2,4 2,5 2,4 2,5 5,0ao12  5,0ao12  5,0ao12  5,0ao12  5,0ao12 2,4     2,5     5,0      7,5       7,4       7,4       7,4      7,4       7,4       7,4      7,4      7,4     7,4     7,10    7,0     7,0     7,2     2,4 2,5 2,4 2,5 2,4 2,5 2,4 3,0
2,3 2,2 2,3 2,2 2,3 2,2 1,3 5,0      5,0      5,0ao12  5,0t1,0  5,0t1,1 2,2     2,3     5,0tb3,1 5,0tb3,1  5,0tb3,1  5,0tb3,1  5,0tb3,1 5,0tb3,1  5,0tb3,1  5,0tb3,1 5,0      5,0     5,0     7,5     7,4     7,4     7,6     1,2 2,3 2,2 2,3 2,2 2,3 2,2 3,0
2,5 2,4 2,5 2,4 2,5 2,4 2,5 5,0      5,0      5,0ao12  2,2      2,3     2,4     2,5     6,0      6,0       6,0       6,0       6,0      6,0       6,0       6,0      6,0      6,0     6,0     6,0     6,0     6,0     6,0     2,4 2,5 2,4 2,5 2,4 2,5 2,4 3,0
2,3 2,2 2,3 2,2 2,3 2,2 1,3 5,0      5,0ao12  5,0ao12  1,4      1,5     2,2     2,3     6,0      6,0       6,0       6,0       6,0      6,0       6,0       6,0      6,0      6,0     6,0     6,0     6,0     6,0     6,0     1,2 2,3 2,2 2,3 2,2 2,3 2,2 3,0
2,5 2,4 2,5 2,4 2,5 2,4 2,5 5,0      5,1ao12  5,2      5,0      5,1     2,4     2,5     6,0      6,0       6,0       6,0       6,0      6,0       6,0       6,0      6,0      6,0     6,0     6,0     6,0     6,0     6,0     2,4 2,5 2,4 2,5 2,4 2,5 2,4 3,0
2,3 2,2 2,3 2,2 2,3 2,2 1,3 5,0      5,0ao12  5,2      5,0ao12  5,2     2,2     2,3     6,0      6,0       6,0       6,0       6,0      6,0       6,0       6,0      6,0      6,0     6,0     6,0     6,0     6,0     6,0     1,2 2,3 2,2 2,3 2,2 2,3 2,2 3,0
2,5 2,4 2,5 2,4 2,5 2,4 2,5 5,0ao12  5,3ao12  5,0ao12  5,0ao12  5,2     2,4     2,5     6,0      6,0       6,0       6,0       6,0      6,0       6,0       6,0      6,0      6,0     6,0     6,0     6,0     6,0     6,0     2,4 2,5 2,4 2,5 2,4 2,5 2,4 3,0
2,3 2,2 2,3 2,2 2,3 2,2 1,3 5,1tb3,1 5,0ao12  5,1tb3,1 5,1tb3,1 5,0     2,2     2,3     6,0      6,0       6,0       6,0       6,0      6,0       6,0       6,0      6,0      6,0     6,0     6,0     6,0     6,0     6,0     1,2 2,3 2,2 2,3 2,2 2,3 2,2 3,0
2,5 2,4 2,5 2,4 2,5 2,4 2,5 5,0ao12  5,0ao12  5,0ao12  5,0ao12  5,0ao12 1,4     1,5     5,0      5,0       5,0       7,7       7,3      7,3       7,3       7,3      7,3      7,3     7,3     7,3     7,3     7,3     7,8     2,4 2,5 2,4 2,5 2,4 2,5 2,4 3,0
2,3 2,2 2,3 2,2 2,3 2,2 1,3 5,0ao12  5,1tb3,1 5,1tb3,1 5,1tb3,1 5,0ao12 3,4     5,0     5,0      5,0       5,0       7,1       7,0      7,9       7,4       7,4      7,4      7,4     7,4     7,4     7,4     7,4     7,6     1,2 2,3 2,2 2,3 2,2 2,3 2,2 3,0
2,5 2,4 2,5 2,4 2,5 2,4 2,5 5,0ao12  5,0ao12  5,0ao12  5,0ao12  5,0ao12 3,4     5,0     5,0      5,0       5,0       7,5       7,4      7,6       6,0       6,0      6,0      6,0     6,0     6,0     6,0     6,0     6,0     2,4 2,5 2,4 2,5 2,4 2,5 2,4 3,0
2,3 2,2 2,3 2,2 2,3 2,2 1,3 5,0ao12  3,6t1,0  3,6t1,1  3,6t1,0  3,6t1,1 3,7t1,0 5,1t1,1 5,1t1,0  5,1t1,1   5,1t1,0   5,1t1,1   5,1t1,0  5,1t1,1   6,0       6,0      6,0      6,0     6,0     6,0     6,0     6,0     6,0     1,2 2,3 2,2 2,3 2,2 2,3 2,2 3,0
2,5 2,4 2,5 2,4 2,5 2,4 2,5 5,0ao12  1,2      1,3      1,2      1,3     1,2     1,3     1,2      1,3       1,2       1,3       1,2      1,3       6,0       6,0      6,0      6,0     6,0     6,0     6,0     6,0     6,0     2,4 2,5 2,4 2,5 2,4 2,5 2,4 3,0
2,3 2,2 2,3 2,2 2,3 2,2 1,3 5,0      1,4      1,5      1,4      1,5     1,4     1,5     1,4      1,5       1,4       1,5       1,4      1,5       6,0       6,0      6,0      6,0     6,0     6,0     6,0     6,0     6,0     1,2 2,3 2,2 2,3 2,2 2,3 2,2 3,0
2,5 2,4 2,5 2,4 2,5 2,4 2,5 5,0      5,0      5,0      5,0      5,0     5,0     5,0     5,0      5,0       5,0       7,7       7,3      7,8       6,0       6,0      6,0      6,0     6,0     6,0     6,0     6,0     6,0     2,4 2,5 2,4 2,5 2,4 2,5 2,4 3,0
2,3 2,2 2,3 2,2 2,3 2,2 1,3 5,0      5,0      5,0      7,7      7,3     7,3     7,3     7,3      7,3       7,3       7,12      7,0      7,2       6,0       6,0      6,0      6,0     6,0     6,0     6,0     6,0     6,0     1,2 2,3 2,2 2,3 2,2 2,3 2,2 3,0
2,5 2,4 2,5 2,4 2,5 2,4 2,5 5,0      5,0      5,0      7,1      7,0     7,0     7,9     7,4      7,4       7,4       7,4       7,4      7,6       5,1       5,1      5,0      5,3     5,0     5,0     5,0     5,0     5,1     2,4 2,5 2,4 2,5 2,4 2,5 2,4 3,0
2,3 2,2 2,3 2,2 2,3 2,2 1,3 5,0tb3,1 5,0tb3,1 5,0tb3,1 7,1      7,0     7,0     7,2     5,2      5,0       5,0tb3,1  5,0tb3,1  5,0tb3,1 5,0tb3,1  5,0tb3,1  5,0tb3,1 3,6      3,6     3,6     3,6     3,6     3,6     3,6     1,2 2,3 2,2 2,3 2,2 2,3 2,2 3,0
2,5 2,4 2,5 2,4 2,5 2,4 2,5 5,0      5,0      5,0      7,1      7,0     7,0     7,11    7,3      7,3       7,3       7,3       7,3      7,3       7,3       7,3      7,3      7,3     7,3     7,3     7,3     7,3     7,8     2,4 2,5 2,4 2,5 2,4 2,5 2,4 3,0
2,3 2,2 2,3 2,2 2,3 2,2 1,3 5,0      5,0      5,0      7,5      7,4     7,4     7,4     7,4      7,4       7,4       7,4       7,4      7,4       7,4       7,4      7,4      7,4     7,10    7,0     7,0     7,0     7,2     1,2 2,3 2,2 2,3 2,2 2,3 2,2 3,0
2,5 2,4 2,5 2,4 2,5 2,4 2,5 5,0      5,0      5,3      5,0      5,0     5,0     5,0     5,0      5,0       5,3       5,0       5,0      5,0       5,0       5,0      5,0      5,0     7,1     7,0     7,0     7,0     7,2     2,4 2,5 2,4 2,5 2,4 2,5 2,4 3,0
2,3 2,2 2,3 2,2 2,3 2,2 1,3 5,1t1,0  5,1t1,1  5,1t1,0  5,3t1,1  5,1t1,0 5,0t1,1 5,0t1,0 5,3t1,1  5,3t1,0   5,3t1,1   6,0       6,0      6,0       6,0       6,0      6,0      6,0     7,1     7,0     7,0     7,0     7,2     1,2 2,3 2,2 2,3 2,2 2,3 2,2 3,0
2,5 2,4 2,5 2,4 2,5 2,4 2,5 1,2      1,3      1,2      1,3      1,2     1,3     1,2     1,3      1,2       1,3       6,0       6,0      6,0       6,0       6,0      6,0      6,0     7,1     7,0     7,0     7,0     7,2     2,4 2,5 2,4 2,5 2,4 2,5 2,4 3,0
2,3 2,2 2,3 2,2 2,3 2,2 1,3 1,4      1,5      1,4      1,5      1,4     1,5     1,4     1,5      1,4       1,5       6,0       6,0      6,0       6,0       6,0      6,0      6,0     7,1     7,0     7,0     7,0     7,2     1,2 2,3 2,2 2,3 2,2 2,3 2,2 3,0
2,5 2,4 2,5 2,4 2,5 2,4 2,5 5,0      5,0ao12  5,0      5,2ao12  5,0     5,0     5,0     5,0      5,0       5,0       6,0       6,0      6,0       6,0       6,0      6,0      6,0     7,1     7,0     7,0     7,0     7,2     2,4 2,5 2,4 2,5 2,4 2,5 2,4 3,0
2,3 2,2 2,3 2,2 2,3 2,2 1,3 5,1ao12  5,0      5,0ao12  5,0      5,3     5,0     5,0     5,0      5,0       5,0       6,0       6,0      6,0       6,0       6,0      6,0      6,0     7,1     7,0     7,0     7,0     7,2     1,2 2,3 2,2 2,3 2,2 2,3 2,2 3,0
2,5 2,4 2,5 2,4 2,5 2,4 2,5 7,7      7,3      7,3      7,3      7,3     7,3     7,3     7,3      7,3       7,3       7,3       7,3      7,3       7,3       7,3      7,3      7,3     7,12    7,0     7,0     7,0     7,2     2,4 2,5 2,4 2,5 2,4 2,5 2,4 3,0
2,3 2,2 2,3 2,2 2,3 2,2 1,3 7,5      7,4      7,4      7,4      7,4     7,4     7,4     7,4      7,4       7,10      7,0       7,0      7,9       7,4       7,4      7,4      7,4     7,4     7,4     7,4     7,4     7,6     1,2 2,3 2,2 2,3 2,2 2,3 2,2 3,0
2,5 2,4 2,5 2,4 2,5 2,4 2,5 5,0tb3,1 5,0tb3,1 5,0tb3,1 5,0tb3,1 5,0     5,0     5,0     6,1      5,0tb3,1  7,1tb3,1  7,0tb3,1  7,0tb3,1 7,2tb3,1  5,0tb3,1  3,6      3,6      3,6     3,6     3,6     3,6     3,6     3,6     2,4 2,5 2,4 2,5 2,4 2,5 2,4 3,0
2,3 2,2 2,3 2,2 2,3 2,2 1,3 5,0      5,0      6,0      6,0      6,0     6,0     6,0     6,0      6,0       7,1       7,0       7,0      7,2       5,0       6,0      6,0      6,0     6,0     6,0     6,0     6,0     6,0     1,2 2,3 2,2 2,3 2,2 2,3 2,2 3,0
2,5 2,4 2,5 2,4 2,5 2,4 2,5 5,0      5,0      6,0      6,0      6,0     6,0     6,0     6,0      6,0       7,1       7,0       7,0      7,2       5,0       6,0      6,0      6,0     6,0     6,0     6,0     6,0     6,0     2,4 2,5 2,4 2,5 2,4 2,5 2,4 3,0
2,3 2,2 2,3 2,2 2,3 2,2 1,3 6,0      6,0      6,0      6,0      6,0     6,0     6,0     5,0      5,0ao12   7,5       7,4       7,4      7,6       5,0       6,0      6,0      6,0     6,0     6,0     6,0     6,0     6,0     1,2 2,3 2,2 2,3 2,2 2,3 2,2 3,0
2,5 2,4 2,5 2,4 2,5 2,4 2,5 6,0      6,0      6,0      6,0      6,0     6,0     6,0     5,0ao12  5,0       5,0       6,0       6,0      5,0       5,0       6,0      6,0      6,0     6,0     6,0     6,0     6,0     6,0     2,4 2,5 2,4 2,5 2,4 2,5 2,4 3,0
2,3 2,2 2,3 2,2 2,3 2,2 1,3 3,6      3,6      3,6      3,6      3,6     3,6     3,6     3,6      3,6       5,0tb3,2  6,0       6,0      5,0tb3,0  3,6       3,6      3,6      3,6     3,6     3,6     3,6     3,6     3,6     1,2 2,3 2,2 2,3 2,2 2,3 2,2 3,0
2,5 2,4 2,5 2,4 2,5 2,4 2,5 5,1t1,0  5,0t1,1  5,1t1,0  5,1t1,1  5,0t1,0 5,1t1,1 5,1t1,0 5,1t1,1  5,1t1,0   3,4t1,1   6,0       6,0      3,3t1,0   5,2t1,1   5,1t1,0  5,1t1,1  5,3t1,0 5,1t1,1 5,1t1,0 5,1t1,1 5,1t1,0 5,1t1,1 2,4 2,5 2,4 2,5 2,4 2,5 2,4 3,0
2,3 2,2 2,3 2,2 2,3 2,2 2,3 1,2      1,3      1,2      1,3      1,2     1,3     1,2     1,3      1,2       1,3       6,0       6,0      1,2       1,3       1,2      1,3      1,2     1,3     1,2     1,3     1,2     1,3     2,2 2,3 2,2 2,3 2,2 2,3 2,2 3,0
2,5 2,4 2,5 2,4 2,5 2,4 2,5 2,4      2,5      2,4      2,5      2,4     2,5     2,4     2,5      2,4       2,5       6,0       6,0      2,4       2,5       2,4      2,5      2,4     2,5     2,4     2,5     2,4     2,5     2,4 2,5 2,4 2,5 2,4 2,5 2,4 3,0
