2,3 2,2 2,3 2,2 2,3 2,2 1,3 2,2     1,3     2,2     1,3     2,2     1,3     2,2     1,3     5,0     5,0      5,0      5,0 5,0      5,0     2,2     2,3     2,2     2,3     2,2     2,3     2,2     2,3     2,2 2,3 2,2 2,3 2,2 2,3 2,2 3,0
2,5 2,4 2,5 2,4 2,5 2,4 2,5 1,4     1,5     1,4     1,5     1,4     1,5     1,4     1,5     5,0     5,0      5,0      5,0 5,0      5,0     1,4     1,5     1,4     1,5     1,4     1,5     1,4     1,5     2,4 2,5 2,4 2,5 2,4 2,5 2,4 3,0
2,3 2,2 2,3 2,2 2,3 2,2 1,3 5,0     5,0     5,0     5,0     5,0     5,0     5,0     5,0     5,0     5,0      5,0      5,0 5,0      5,0     5,0     5,0     5,0     5,0     5,0     5,0     5,0     5,0     1,2 2,3 2,2 2,3 2,2 2,3 2,2 3,0
2,5 2,4 2,5 2,4 2,5 2,4 2,5 5,0     5,0     5,0     5,0     5,0     5,0     5,0     5,0     5,0     5,0      5,0      5,0 5,0      5,0     5,0     5,0     5,0     5,0     5,0     5,0     5,0     5,0     2,4 2,5 2,4 2,5 2,4 2,5 2,4 3,0
2,3 2,2 2,3 2,2 2,3 2,2 1,3 5,0     5,0     5,0     5,0     5,0     5,0     5,0     5,0     5,0     5,0      5,0      5,0 5,0      5,0     5,0     5,0     5,0     5,0     5,0     5,0     5,0     5,0     1,2 2,3 2,2 2,3 2,2 2,3 2,2 3,0
2,5 2,4 2,5 2,4 2,5 2,4 2,5 5,0     5,0     5,0     5,0     5,0     5,0     5,0     5,0     5,0     5,0      5,0      5,0 5,0      5,0     5,0     5,0     5,0     5,0     5,0     5,0     5,0     5,0     2,4 2,5 2,4 2,5 2,4 2,5 2,4 3,0
2,3 2,2 2,3 2,2 2,3 2,2 1,3 5,0     5,0     5,0     5,0     5,0     5,0     5,0     5,0     5,0     5,0      5,0      5,0 5,0      5,0     5,0     5,0     5,0     5,0     5,0     5,0     5,0     5,0     1,2 2,3 2,2 2,3 2,2 2,3 2,2 3,0
2,5 2,4 2,5 2,4 2,5 2,4 2,5 5,0     5,0     5,0     5,0     5,0     5,0     5,0     5,0     5,0     5,0      5,0      5,0 5,0      5,0     5,0     5,0     5,0     5,0     5,0     5,0     5,0     5,0     2,4 2,5 2,4 2,5 2,4 2,5 2,4 3,0
2,3 2,2 2,3 2,2 2,3 2,2 1,3 5,0     5,0ao12 5,0     5,0     5,0     5,1     5,0     5,0     5,0     5,0      5,0      5,0 5,0      5,0     5,0     5,0     5,0     5,0     5,0     5,0     5,0     5,0     1,2 2,3 2,2 2,3 2,2 2,3 2,2 3,0
2,5 2,4 2,5 2,4 2,5 2,4 2,5 5,0ao12 5,0     5,0     5,0     5,0     5,0     5,0     5,0     5,0     5,0      5,0      5,0 5,0      5,0     5,0     5,0     5,0     5,0     5,0     5,0     5,0     5,0     2,4 2,5 2,4 2,5 2,4 2,5 2,4 3,0
2,3 2,2 2,3 2,2 2,3 2,2 1,3 5,0     5,0ao12 5,0     5,0     5,0     5,0     5,0     5,0     5,0     5,0      5,0      5,0 5,0      5,0     5,0     5,0     5,0     5,0     5,0     5,0     5,0     5,0     1,2 2,3 2,2 2,3 2,2 2,3 2,2 3,0
2,5 2,4 2,5 2,4 2,5 2,4 2,5 5,0ao12 5,0     5,0     5,0     5,0     5,0     5,0     5,0     5,0     5,0      5,0      5,0 5,0      5,0     5,0     5,0     5,0     5,0     5,0     5,0     5,0     5,0     2,4 2,5 2,4 2,5 2,4 2,5 2,4 3,0
2,3 2,2 2,3 2,2 2,3 2,2 1,3 5,0     5,0     5,0     5,0     5,0     5,0     5,0     5,0     5,0     5,0      5,0      5,0 5,0      5,0     5,0     5,0     5,0     5,0     5,0     5,0     5,0     5,0     1,2 2,3 2,2 2,3 2,2 2,3 2,2 3,0
2,5 2,4 2,5 2,4 2,5 2,4 2,5 5,0ao12 5,0     5,0     5,0     5,0     5,0     5,0     5,0     5,0     5,0      5,0      5,0 5,0      5,0     5,0     5,0     5,0     5,0     5,0     5,0     5,0     5,0     2,4 2,5 2,4 2,5 2,4 2,5 2,4 3,0
2,3 2,2 2,3 2,2 2,3 2,2 1,3 5,0     5,0ao12 5,0     5,0     5,0     5,0     5,0     5,0     5,0     5,0      5,0      5,0 5,0      5,0     5,0     5,0     5,0     5,0     5,0     5,0     5,0     5,0     1,2 2,3 2,2 2,3 2,2 2,3 2,2 3,0
2,5 2,4 2,5 2,4 2,5 2,4 2,5 5,0     5,0     5,0     5,0     5,0     5,0     5,0     5,0     5,0     5,0      5,0      5,0 5,0      5,0     5,0     5,0     5,0     5,0     5,0     5,0     5,0     5,0     2,4 2,5 2,4 2,5 2,4 2,5 2,4 3,0
2,3 2,2 2,3 2,2 2,3 2,2 1,3 5,0     5,0     5,0     5,0     5,0     5,0     5,0     5,0     5,0     5,0      5,0      5,0 5,0      5,0     5,0     5,0     5,0     5,0     5,0     5,0     5,0     5,0     1,2 2,3 2,2 2,3 2,2 2,3 2,2 3,0
2,5 2,4 2,5 2,4 2,5 2,4 2,5 5,0     5,0     5,0     5,0     5,0     5,0     5,0     5,0     5,0     5,0      5,0      5,0 5,0      5,0     5,0     5,0     5,0     5,1     5,0     5,0     5,0     5,0     2,4 2,5 2,4 2,5 2,4 2,5 2,4 3,0
2,3 2,2 2,3 2,2 2,3 2,2 1,3 5,0     5,0     5,0     5,0     5,0     5,0     5,0     5,0     5,0     5,0      5,0      5,0 5,0      5,0     5,0     5,0     5,0     5,0     5,0     5,0     5,0     5,0     1,2 2,3 2,2 2,3 2,2 2,3 2,2 3,0
2,5 2,4 2,5 2,4 2,5 2,4 2,5 5,0     5,0     5,0     5,0     5,0     5,0     5,0     5,0     5,0     5,0      5,0      5,0 5,0      5,0     5,0     5,0     5,0     5,0     5,0     5,0     5,0     5,0     2,4 2,5 2,4 2,5 2,4 2,5 2,4 3,0
2,3 2,2 2,3 2,2 2,3 2,2 1,3 5,0     5,0     5,0     5,0     5,0     5,0     5,0     5,0     5,0     5,0      5,0      5,0 5,0      5,0     5,0     5,0     5,0     5,0     5,0     5,0     5,0     5,0     1,2 2,3 2,2 2,3 2,2 2,3 2,2 3,0
2,5 2,4 2,5 2,4 2,5 2,4 2,5 5,0     5,0     5,0     5,0     5,0     5,0     5,0     5,0     5,0     5,0      5,0      5,0 5,0      5,1     5,0     5,0     5,0     5,0     5,0     5,0     5,0     5,0     2,4 2,5 2,4 2,5 2,4 2,5 2,4 3,0
2,3 2,2 2,3 2,2 2,3 2,2 1,3 5,0     5,0     5,0     5,0     5,0     5,0     5,0     5,0     5,0     5,0      5,0      5,0 5,0      5,0     5,0     5,0     5,0     5,0     5,0     5,0     5,0     5,0     1,2 2,3 2,2 2,3 2,2 2,3 2,2 3,0
2,5 2,4 2,5 2,4 2,5 2,4 2,5 5,0     5,0     5,0     5,0     5,0     5,0     5,0     5,0     5,0     5,0      5,0      5,0 5,0      5,0     5,0     5,0     5,0     5,0     5,0     5,0     5,0     5,0     2,4 2,5 2,4 2,5 2,4 2,5 2,4 3,0
2,3 2,2 2,3 2,2 2,3 2,2 1,3 5,0     5,0     5,0     5,0     5,0     5,0     5,0     5,0     5,0     5,0      5,0      5,0 5,0      5,0     5,0     5,0     5,0     5,0     5,0     5,0     5,0     5,0     1,2 2,3 2,2 2,3 2,2 2,3 2,2 3,0
2,5 2,4 2,5 2,4 2,5 2,4 2,5 5,0     5,0     5,0     5,0     5,0     5,0     5,0     5,0     5,0     5,0      5,0      5,0 5,0      5,0     5,0     5,0     5,0     5,0     5,0     5,0     5,0     5,0     2,4 2,5 2,4 2,5 2,4 2,5 2,4 3,0
2,3 2,2 2,3 2,2 2,3 2,2 1,3 5,0     5,0     5,0     5,0     5,0     5,0     5,0     5,0     5,0     5,0      5,0      5,0 5,0      5,0     5,0     5,0     5,0     5,0     5,0     5,0     5,0     5,0     1,2 2,3 2,2 2,3 2,2 2,3 2,2 3,0
2,5 2,4 2,5 2,4 2,5 2,4 2,5 5,0     5,0     5,0     5,0     5,0     5,0     5,0     5,0     5,0     5,0      5,0      5,0 5,0      5,0     5,0     5,0     5,0     5,0     5,0     5,0     5,0     5,0     2,4 2,5 2,4 2,5 2,4 2,5 2,4 3,0
2,3 2,2 2,3 2,2 2,3 2,2 1,3 5,0     5,0     5,0     5,0     5,0     5,0     5,0     5,0     5,0     5,0      5,0      5,0 5,0      5,0     5,0     5,0     5,0     5,0     5,0     5,0     5,0     5,0     1,2 2,3 2,2 2,3 2,2 2,3 2,2 3,0
2,5 2,4 2,5 2,4 2,5 2,4 2,5 5,0     5,0     5,0     5,0     5,0     5,0     5,0     5,0     5,0     5,0      5,0      5,0 5,0      5,0     5,0     5,0     5,0     5,0     5,0     5,0     5,0     5,0     2,4 2,5 2,4 2,5 2,4 2,5 2,4 3,0
2,3 2,2 2,3 2,2 2,3 2,2 1,3 5,0     5,0     5,0     5,0     5,0     5,0     5,0     5,0     5,0     5,0      5,0      5,0 5,0      5,0     5,0     5,0     5,0     5,0     5,0     5,0     5,0     5,0     1,2 2,3 2,2 2,3 2,2 2,3 2,2 3,0
2,5 2,4 2,5 2,4 2,5 2,4 2,5 5,0     5,0     5,0     5,0     5,0     5,0     5,0     5,0     5,0     5,0      5,0      5,0 5,0      5,0     5,1     5,0     5,0     5,0     5,0     5,0     5,0     5,0     2,4 2,5 2,4 2,5 2,4 2,5 2,4 3,0
2,3 2,2 2,3 2,2 2,3 2,2 1,3 5,0     5,0     5,0     5,0     5,0     5,0     5,0     5,0     5,0     5,0      5,0      5,0 5,0      5,0     5,0     5,0     5,0     5,0     5,0     5,0     5,0     5,0     1,2 2,3 2,2 2,3 2,2 2,3 2,2 3,0
2,5 2,4 2,5 2,4 2,5 2,4 2,5 5,0     5,0     5,0     5,0     5,0     5,0     5,0     5,0     5,0     5,0      5,0      5,0 5,0      5,0     5,0     5,0     5,0     5,0     5,0     5,0     5,0     5,0     2,4 2,5 2,4 2,5 2,4 2,5 2,4 3,0
2,3 2,2 2,3 2,2 2,3 2,2 1,3 5,0     5,0     5,0     5,0     5,0     5,0     5,0     5,0     5,0     5,0      5,0      5,0 5,0      5,0     5,0     5,0     5,0     5,0     5,0     5,0     5,0     5,0     1,2 2,3 2,2 2,3 2,2 2,3 2,2 3,0
2,5 2,4 2,5 2,4 2,5 2,4 2,5 5,0     5,0     5,0     5,0     5,0     5,0     5,0     5,0     5,0     5,0      6,0      6,0 5,0      5,0     5,0     5,0     5,0     5,0     5,0     5,0     5,0     5,0     2,4 2,5 2,4 2,5 2,4 2,5 2,4 3,0
2,3 2,2 2,3 2,2 2,3 2,2 1,3 3,6     3,6     3,6     3,6     3,6     3,6     3,6     3,6     3,6     5,0tb3,2 6,0      6,0 5,0tb3,0 3,6     3,6     3,6     3,6     3,6     3,6     3,6     3,6     3,6     1,2 2,3 2,2 2,3 2,2 2,3 2,2 3,0
2,5 2,4 2,5 2,4 2,5 2,4 2,5 5,1t1,0 5,1t1,1 5,1t1,0 5,1t1,1 5,1t1,0 5,1t1,1 5,1t1,0 5,1t1,1 5,1t1,0 3,4t1,1  6,0      6,0 3,3t1,0  5,1t1,1 5,1t1,0 5,1t1,1 5,1t1,0 5,1t1,1 5,1t1,0 5,1t1,1 5,1t1,0 5,1t1,1 2,4 2,5 2,4 2,5 2,4 2,5 2,4 3,0
2,3 2,2 2,3 2,2 2,3 2,2 2,3 1,2     1,3     1,2     1,3     1,2     1,3     1,2     1,3     1,2     1,3      6,0      6,0 1,2      1,3     1,2     1,3     1,2     1,3     1,2     1,3     1,2     1,3     2,2 2,3 2,2 2,3 2,2 2,3 2,2 3,0
2,5 2,4 2,5 2,4 2,5 2,4 2,5 2,4     2,5     2,4     2,5     2,4     2,5     2,4     2,5     2,4     2,5      6,0      6,0 2,4      2,5     2,4     2,5     2,4     2,5     2,4     2,5     2,4     2,5     2,4 2,5 2,4 2,5 2,4 2,5 2,4 3,0
