3,0 3,0 3,0 3,0 3,0 3,0 3,0 3,0     3,0     3,0 3,0 3,0 3,0 3,0 3,0 0,0 0,0 0,0 0,0 0,0 0,0 3,0 3,0 3,0 3,0 3,0 3,0 3,0 3,0 3,0 3,0 3,0 3,0 3,0 3,0 3,0 3,0
3,0 3,0 3,0 3,0 3,0 3,0 3,0 3,0     3,0     3,0 3,0 3,0 3,0 3,0 3,0 0,0 0,0 0,0 0,0 0,0 0,0 3,0 3,0 3,0 3,0 3,0 3,0 3,0 3,0 3,0 3,0 3,0 3,0 3,0 3,0 3,0 3,0
3,0 3,0 3,0 3,0 3,0 3,0 3,0 0,0     0,0     0,0 0,0 0,0 0,0 0,0 0,0 0,0 0,0 0,0 0,0 0,0 0,0 0,0 0,0 0,0 0,0 0,0 0,0 0,0 0,0 3,0 3,0 3,0 3,0 3,0 3,0 3,0 3,0
3,0 3,0 3,0 3,0 3,0 3,0 3,0 0,0     0,0     0,0 0,0 0,0 0,0 0,0 0,0 0,0 0,0 0,0 0,0 0,0 0,0 0,0 0,0 0,0 0,0 0,0 0,0 0,0 0,0 3,0 3,0 3,0 3,0 3,0 3,0 3,0 3,0
3,0 3,0 3,0 3,0 3,0 3,0 3,0 0,0     0,0     0,0 0,0 0,0 0,0 0,0 0,0 0,0 0,0 0,0 0,0 0,0 0,0 0,0 0,0 0,0 0,0 0,0 0,0 0,0 0,0 3,0 3,0 3,0 3,0 3,0 3,0 3,0 3,0
3,0 3,0 3,0 3,0 3,0 3,0 3,0 0,0     0,0     0,0 0,0 0,0 0,0 0,0 0,0 0,0 0,0 0,0 0,0 0,0 0,0 0,0 0,0 0,0 0,0 0,0 0,0 0,0 0,0 3,0 3,0 3,0 3,0 3,0 3,0 3,0 3,0
3,0 3,0 3,0 3,0 3,0 3,0 3,0 0,0     0,0     0,0 0,0 0,0 0,0 0,0 0,0 0,0 0,0 0,0 0,0 0,0 0,0 0,0 0,0 0,0 0,0 0,0 0,0 0,0 0,0 3,0 3,0 3,0 3,0 3,0 3,0 3,0 3,0
3,0 3,0 3,0 3,0 3,0 3,0 3,0 0,0     5,0ao12 0,0 0,0 0,0 0,0 0,0 0,0 0,0 0,0 0,0 0,0 0,0 0,0 0,0 0,0 0,0 0,0 0,0 0,0 0,0 0,0 3,0 3,0 3,0 3,0 3,0 3,0 3,0 3,0
3,0 3,0 3,0 3,0 3,0 3,0 3,0 5,0ao12 0,0     0,0 0,0 0,0 0,0 0,0 0,0 0,0 0,0 0,0 0,0 0,0 0,0 0,0 0,0 0,0 0,0 0,0 0,0 0,0 0,0 3,0 3,0 3,0 3,0 3,0 3,0 3,0 3,0
3,0 3,0 3,0 3,0 3,0 3,0 3,0 0,0     5,0ao12 0,0 0,0 0,0 0,0 0,0 0,0 0,0 0,0 0,0 0,0 0,0 0,0 0,0 0,0 0,0 0,0 0,0 0,0 0,0 0,0 3,0 3,0 3,0 3,0 3,0 3,0 3,0 3,0
3,0 3,0 3,0 3,0 3,0 3,0 3,0 5,0ao12 0,0     0,0 0,0 0,0 0,0 0,0 0,0 0,0 0,0 0,0 0,0 0,0 0,0 0,0 0,0 0,0 0,0 0,0 0,0 0,0 0,0 3,0 3,0 3,0 3,0 3,0 3,0 3,0 3,0
3,0 3,0 3,0 3,0 3,0 3,0 3,0 0,0     0,0     0,0 0,0 0,0 0,0 0,0 0,0 0,0 0,0 0,0 0,0 0,0 0,0 0,0 0,0 0,0 0,0 0,0 0,0 0,0 0,0 3,0 3,0 3,0 3,0 3,0 3,0 3,0 3,0
3,0 3,0 3,0 3,0 3,0 3,0 3,0 0,0     5,0ao12 0,0 0,0 0,0 0,0 0,0 0,0 0,0 0,0 0,0 0,0 0,0 0,0 0,0 0,0 0,0 0,0 0,0 0,0 0,0 0,0 3,0 3,0 3,0 3,0 3,0 3,0 3,0 3,0
3,0 3,0 3,0 3,0 3,0 3,0 3,0 5,0ao12 0,0     0,0 0,0 0,0 0,0 0,0 0,0 0,0 0,0 0,0 0,0 0,0 0,0 0,0 0,0 0,0 0,0 0,0 0,0 0,0 0,0 3,0 3,0 3,0 3,0 3,0 3,0 3,0 3,0
3,0 3,0 3,0 3,0 3,0 3,0 3,0 0,0     5,0ao12 0,0 0,0 0,0 0,0 0,0 0,0 0,0 0,0 0,0 0,0 0,0 0,0 0,0 0,0 0,0 0,0 0,0 0,0 0,0 0,0 3,0 3,0 3,0 3,0 3,0 3,0 3,0 3,0
3,0 3,0 3,0 3,0 3,0 3,0 3,0 0,0     0,0     0,0 0,0 0,0 0,0 0,0 0,0 0,0 0,0 0,0 0,0 0,0 0,0 0,0 0,0 0,0 0,0 0,0 0,0 0,0 0,0 3,0 3,0 3,0 3,0 3,0 3,0 3,0 3,0
3,0 3,0 3,0 3,0 3,0 3,0 3,0 0,0     0,0     0,0 0,0 0,0 0,0 0,0 0,0 0,0 0,0 0,0 0,0 0,0 0,0 0,0 0,0 0,0 0,0 0,0 0,0 0,0 0,0 3,0 3,0 3,0 3,0 3,0 3,0 3,0 3,0
3,0 3,0 3,0 3,0 3,0 3,0 3,0 0,0     0,0     0,0 0,0 0,0 0,0 0,0 0,0 0,0 0,0 0,0 0,0 0,0 0,0 0,0 0,0 0,0 0,0 0,0 0,0 0,0 0,0 3,0 3,0 3,0 3,0 3,0 3,0 3,0 3,0
3,0 3,0 3,0 3,0 3,0 3,0 3,0 0,0     0,0     0,0 0,0 0,0 0,0 0,0 0,0 0,0 0,0 0,0 0,0 0,0 0,0 0,0 0,0 0,0 0,0 0,0 0,0 0,0 0,0 3,0 3,0 3,0 3,0 3,0 3,0 3,0 3,0
3,0 3,0 3,0 3,0 3,0 3,0 3,0 0,0     0,0     0,0 0,0 0,0 0,0 0,0 0,0 0,0 0,0 0,0 0,0 0,0 0,0 0,0 0,0 0,0 0,0 0,0 0,0 0,0 0,0 3,0 3,0 3,0 3,0 3,0 3,0 3,0 3,0
3,0 3,0 3,0 3,0 3,0 3,0 3,0 0,0     0,0     0,0 0,0 0,0 0,0 0,0 0,0 0,0 0,0 0,0 0,0 0,0 0,0 0,0 0,0 0,0 0,0 0,0 0,0 0,0 0,0 3,0 3,0 3,0 3,0 3,0 3,0 3,0 3,0
3,0 3,0 3,0 3,0 3,0 3,0 3,0 0,0     0,0     0,0 0,0 0,0 0,0 0,0 0,0 0,0 0,0 0,0 0,0 0,0 0,0 0,0 0,0 0,0 0,0 0,0 0,0 0,0 0,0 3,0 3,0 3,0 3,0 3,0 3,0 3,0 3,0
3,0 3,0 3,0 3,0 3,0 3,0 3,0 0,0     0,0     0,0 0,0 0,0 0,0 0,0 0,0 0,0 0,0 0,0 0,0 0,0 0,0 0,0 0,0 0,0 0,0 0,0 0,0 0,0 0,0 3,0 3,0 3,0 3,0 3,0 3,0 3,0 3,0
3,0 3,0 3,0 3,0 3,0 3,0 3,0 0,0     0,0     0,0 0,0 0,0 0,0 0,0 0,0 0,0 0,0 0,0 0,0 0,0 0,0 0,0 0,0 0,0 0,0 0,0 0,0 0,0 0,0 3,0 3,0 3,0 3,0 3,0 3,0 3,0 3,0
3,0 3,0 3,0 3,0 3,0 3,0 3,0 0,0     0,0     0,0 0,0 0,0 0,0 0,0 0,0 0,0 0,0 0,0 0,0 0,0 0,0 0,0 0,0 0,0 0,0 0,0 0,0 0,0 0,0 3,0 3,0 3,0 3,0 3,0 3,0 3,0 3,0
3,0 3,0 3,0 3,0 3,0 3,0 3,0 0,0     0,0     0,0 0,0 0,0 0,0 0,0 0,0 0,0 0,0 0,0 0,0 0,0 0,0 0,0 0,0 0,0 0,0 0,0 0,0 0,0 0,0 3,0 3,0 3,0 3,0 3,0 3,0 3,0 3,0
3,0 3,0 3,0 3,0 3,0 3,0 3,0 0,0     0,0     0,0 0,0 0,0 0,0 0,0 0,0 0,0 0,0 0,0 0,0 0,0 0,0 0,0 0,0 0,0 0,0 0,0 0,0 0,0 0,0 3,0 3,0 3,0 3,0 3,0 3,0 3,0 3,0
3,0 3,0 3,0 3,0 3,0 3,0 3,0 0,0     0,0     0,0 0,0 0,0 0,0 0,0 0,0 0,0 0,0 0,0 0,0 0,0 0,0 0,0 0,0 0,0 0,0 0,0 0,0 0,0 0,0 3,0 3,0 3,0 3,0 3,0 3,0 3,0 3,0
3,0 3,0 3,0 3,0 3,0 3,0 3,0 0,0     0,0     0,0 0,0 0,0 0,0 0,0 0,0 0,0 0,0 0,0 0,0 0,0 0,0 0,0 0,0 0,0 0,0 0,0 0,0 0,0 0,0 3,0 3,0 3,0 3,0 3,0 3,0 3,0 3,0
3,0 3,0 3,0 3,0 3,0 3,0 3,0 0,0     0,0     0,0 0,0 0,0 0,0 0,0 0,0 0,0 0,0 0,0 0,0 0,0 0,0 0,0 0,0 0,0 0,0 0,0 0,0 0,0 0,0 3,0 3,0 3,0 3,0 3,0 3,0 3,0 3,0
3,0 3,0 3,0 3,0 3,0 3,0 3,0 0,0     0,0     0,0 0,0 0,0 0,0 0,0 0,0 0,0 0,0 0,0 0,0 0,0 0,0 0,0 0,0 0,0 0,0 0,0 0,0 0,0 0,0 3,0 3,0 3,0 3,0 3,0 3,0 3,0 3,0
3,0 3,0 3,0 3,0 3,0 3,0 3,0 0,0     0,0     0,0 0,0 0,0 0,0 0,0 0,0 0,0 0,0 0,0 0,0 0,0 0,0 0,0 0,0 0,0 0,0 0,0 0,0 0,0 0,0 3,0 3,0 3,0 3,0 3,0 3,0 3,0 3,0
3,0 3,0 3,0 3,0 3,0 3,0 3,0 0,0     0,0     0,0 0,0 0,0 0,0 0,0 0,0 0,0 0,0 0,0 0,0 0,0 0,0 0,0 0,0 0,0 0,0 0,0 0,0 0,0 0,0 3,0 3,0 3,0 3,0 3,0 3,0 3,0 3,0
3,0 3,0 3,0 3,0 3,0 3,0 3,0 0,0     0,0     0,0 0,0 0,0 0,0 0,0 0,0 0,0 0,0 0,0 0,0 0,0 0,0 0,0 0,0 0,0 0,0 0,0 0,0 0,0 0,0 3,0 3,0 3,0 3,0 3,0 3,0 3,0 3,0
3,0 3,0 3,0 3,0 3,0 3,0 3,0 0,0     0,0     0,0 0,0 0,0 0,0 0,0 0,0 0,0 0,0 0,0 0,0 0,0 0,0 0,0 0,0 0,0 0,0 0,0 0,0 0,0 0,0 3,0 3,0 3,0 3,0 3,0 3,0 3,0 3,0
3,0 3,0 3,0 3,0 3,0 3,0 3,0 0,0     0,0     0,0 0,0 0,0 0,0 0,0 0,0 0,0 0,0 0,0 0,0 0,0 0,0 0,0 0,0 0,0 0,0 0,0 0,0 0,0 0,0 3,0 3,0 3,0 3,0 3,0 3,0 3,0 3,0
3,0 3,0 3,0 3,0 3,0 3,0 3,0 0,0     0,0     0,0 0,0 0,0 0,0 0,0 0,0 0,0 0,0 0,0 0,0 0,0 0,0 0,0 0,0 0,0 0,0 0,0 0,0 0,0 0,0 3,0 3,0 3,0 3,0 3,0 3,0 3,0 3,0
3,0 3,0 3,0 3,0 3,0 3,0 3,0 0,0     0,0     0,0 0,0 0,0 0,0 0,0 0,0 0,0 0,0 0,0 0,0 0,0 0,0 0,0 0,0 0,0 0,0 0,0 0,0 0,0 0,0 3,0 3,0 3,0 3,0 3,0 3,0 3,0 3,0
3,0 3,0 3,0 3,0 3,0 3,0 3,0 3,0     3,0     3,0 3,0 3,0 3,0 3,0 3,0 3,0 3,0 0,0 0,0 0,0 0,0 3,0 3,0 3,0 3,0 3,0 3,0 3,0 3,0 3,0 3,0 3,0 3,0 3,0 3,0 3,0 3,0
3,0 3,0 3,0 3,0 3,0 3,0 3,0 3,0     3,0     3,0 3,0 3,0 3,0 3,0 3,0 3,0 3,0 0,0 0,0 0,0 0,0 3,0 3,0 3,0 3,0 3,0 3,0 3,0 3,0 3,0 3,0 3,0 3,0 3,0 3,0 3,0 3,0
