2,3 2,2 2,3 2,2 2,3 2,2 1,3 1,3      1,3      2,2      1,3      2,2     2,3     2,2     1,3      7,1      7,0      7,0      7,0      7,0      7,2      2,2      2,3     2,2     2,3     2,2     2,3     2,2     2,3     2,2 2,3 2,2 2,3 2,2 2,3 2,2 3,0
2,3 2,2 2,3 2,2 2,3 2,2 1,3 1,2      1,3      2,2      1,3      2,2     2,3     2,2     1,3      7,1      7,0      7,0      7,0      7,0      7,2      2,2      2,3     2,2     2,3     2,2     2,3     2,2     2,3     2,2 2,3 2,2 2,3 2,2 2,3 2,2 3,0
2,3 2,2 2,3 2,2 2,3 2,2 1,3 2,2      1,3      2,2      1,3      2,2     2,3     2,2     1,3      7,1      7,0      7,0      7,0      7,0      7,2      2,2      2,3     2,2     2,3     2,2     2,3     2,2     2,3     2,2 2,3 2,2 2,3 2,2 2,3 2,2 3,0
2,3 2,2 2,3 2,2 2,3 2,2 1,3 2,2      1,3      2,2      1,3      2,2     2,3     2,2     1,3      7,1      7,0      7,0      7,0      7,0      7,2      2,2      2,3     2,2     2,3     2,2     2,3     2,2     2,3     2,2 2,3 2,2 2,3 2,2 2,3 2,2 3,0
2,3 2,2 2,3 2,2 2,3 2,2 1,3 2,2      1,3      2,2      1,3      2,2     2,3     2,2     1,3      7,1      7,0      7,0      7,0      7,0      7,2      2,2      2,3     2,2     2,3     2,2     2,3     2,2     2,3     2,2 2,3 2,2 2,3 2,2 2,3 2,2 3,0
2,3 2,2 2,3 2,2 2,3 2,2 1,3 2,2      1,3      2,2      1,3      2,2     2,3     2,2     1,3      7,1      7,0      7,0      7,0      7,0      7,2      2,2      2,3     2,2     2,3     2,2     2,3     2,2     2,3     2,2 2,3 2,2 2,3 2,2 2,3 2,2 3,0
2,3 2,2 2,3 2,2 2,3 2,2 1,3 2,2      1,3      2,2      1,3      2,2     2,3     2,2     1,3      7,1      7,0      7,0      7,0      7,0      7,2      2,2      2,3     2,2     2,3     2,2     2,3     2,2     2,3     2,2 2,3 2,2 2,3 2,2 2,3 2,2 3,0
2,3 2,2 2,3 2,2 2,3 2,2 1,3 2,2      1,3      2,2      1,3      2,2     2,3     2,2     1,3      7,1      7,0      7,0      7,0      7,0      7,2      2,2      2,3     2,2     2,3     2,2     2,3     2,2     2,3     2,2 2,3 2,2 2,3 2,2 2,3 2,2 3,0
2,3 2,2 2,3 2,2 2,3 2,2 1,3 2,2      1,3      2,2      1,3      2,2     2,3     2,2     1,3      7,1      7,0      7,0      7,0      7,0      7,2      2,2      2,3     2,2     2,3     2,2     2,3     2,2     2,3     2,2 2,3 2,2 2,3 2,2 2,3 2,2 3,0
2,3 2,2 2,3 2,2 2,3 2,2 1,3 2,2      1,3      2,2      1,3      2,2     2,3     2,2     1,3      7,1      7,0      7,0      7,0      7,0      7,2      2,2      2,3     2,2     2,3     2,2     2,3     2,2     2,3     2,2 2,3 2,2 2,3 2,2 2,3 2,2 3,0
2,3 2,2 2,3 2,2 2,3 2,2 1,3 2,2      1,3      2,2      1,3      2,2     2,3     2,2     1,3      7,1      7,0      7,0      7,0      7,0      7,2      2,2      2,3     2,2     2,3     2,2     2,3     2,2     2,3     2,2 2,3 2,2 2,3 2,2 2,3 2,2 3,0
2,3 2,2 2,3 2,2 2,3 2,2 1,3 2,2      1,3      2,2      1,3      2,2     2,3     2,2     1,3      7,1      7,0      7,0      7,0      7,0      7,2      2,2      2,3     2,2     2,3     2,2     2,3     2,2     2,3     2,2 2,3 2,2 2,3 2,2 2,3 2,2 3,0
2,3 2,2 2,3 2,2 2,3 2,2 1,3 2,2      1,3      2,2      1,3      2,2     2,3     2,2     1,3      7,1      7,0      7,0      7,0      7,0      7,2      2,2      2,3     2,2     2,3     2,2     2,3     2,2     2,3     2,2 2,3 2,2 2,3 2,2 2,3 2,2 3,0
2,3 2,2 2,3 2,2 2,3 2,2 1,3 1,1      1,3      2,2      1,3      2,2     2,3     2,2     1,3      7,1      7,0      7,0      7,0      7,0      7,2      2,2      2,3     2,2     2,3     2,2     2,3     2,2     2,3     2,2 2,3 2,2 2,3 2,2 2,3 2,2 3,0
2,3 2,2 2,3 2,2 2,3 2,2 1,3 2,2      1,3      2,2      1,3      2,2     2,3     2,2     1,3      7,1      7,0      7,0      7,0      7,0      7,2      2,2      2,3     2,2     2,3     2,2     2,3     2,2     2,3     2,2 2,3 2,2 2,3 2,2 2,3 2,2 3,0
2,3 2,2 2,3 2,2 2,3 2,2 1,3 2,2      1,3      2,2      1,3      2,2     2,3     2,2     1,3      7,1      7,0      7,0      7,0      7,0      7,2      2,2      2,3     2,2     2,3     2,2     2,3     2,2     2,3     2,2 2,3 2,2 2,3 2,2 2,3 2,2 3,0
2,3 2,2 2,3 2,2 2,3 2,2 1,3 2,2      1,3      2,2      1,3      2,2     2,3     2,2     1,3      7,1      7,0      7,0      7,0      7,0      7,2      2,2      2,3     2,2     2,3     2,2     2,3     2,2     2,3     2,2 2,3 2,2 2,3 2,2 2,3 2,2 3,0
2,3 2,2 2,3 2,2 2,3 2,2 1,3 1,2      1,3      2,2      1,3      2,2     2,3     2,2     1,3      7,1      7,0      7,0      7,0      7,0      7,2      2,2      2,3     2,2     2,3     2,2     2,3     2,2     2,3     2,2 2,3 2,2 2,3 2,2 2,3 2,2 3,0
2,3 2,2 2,3 2,2 2,3 2,2 1,3 1,2      1,3      2,2      1,3      2,2     2,3     2,2     1,3      7,1      7,0      7,0      7,0      7,0      7,2      2,2      2,3     2,2     2,3     2,2     2,3     2,2     2,3     2,2 2,3 2,2 2,3 2,2 2,3 2,2 3,0
2,3 2,2 2,3 2,2 2,3 2,2 1,3 1,2      1,3      2,2      1,3      2,2     2,3     2,2     1,3      7,1      7,0      7,0      7,0      7,0      7,2      2,2      2,3     2,2     2,3     2,2     2,3     2,2     2,3     2,2 2,3 2,2 2,3 2,2 2,3 2,2 3,0
2,3 2,2 2,3 2,2 2,3 2,2 1,3 1,2      1,3      2,2      1,3      2,2     2,3     2,2     7,8      7,1      7,0      7,0      7,0      7,0      7,2      2,2      2,3     2,2     2,3     2,2     2,3     2,2     2,3     2,2 2,3 2,2 2,3 2,2 2,3 2,2 3,0
2,3 2,2 2,3 2,2 2,3 2,2 1,3 1,2      1,3      2,2      1,3      2,2     2,3     2,2     7,7      7,1      7,0      7,0      7,0      7,0      7,2      2,2      2,3     2,2     2,3     2,2     2,3     2,2     2,3     2,2 2,3 2,2 2,3 2,2 2,3 2,2 3,0
2,3 2,2 2,3 2,2 2,3 2,2 1,3 1,2      1,3      2,2      1,3      2,2     2,3     2,2     7,3      7,1      7,0      7,0      7,0      7,0      7,2      2,2      2,3     2,2     2,3     2,2     2,3     2,2     2,3     2,2 2,3 2,2 2,3 2,2 2,3 2,2 3,0
2,3 2,2 2,3 2,2 2,3 2,2 1,3 1,2      1,3      2,2      1,3      2,2     2,3     7,0     7,0      7,1      7,0      7,0      7,0      7,0      7,2      2,2      2,3     2,2     2,3     2,2     2,3     2,2     2,3     2,2 2,3 2,2 2,3 2,2 2,3 2,2 3,0
